#                                                                                                         #
#                                                                                                         #
#                                                                                                         #
#                                                                                                         #
#                                                                                                         #
#                                                                                                         #
#                                                                                                         #
#                                                                                                         #
#                                                                                                         #
#                                                                                                         #
#                                                                                                         #
#           ====                                            ======            ===                         #
#                       c                                   ######            ###       ===               #
#                   =======  ========\                ======######         ===###       ###               #
#======\            #######==#########======\         ############         ######     c ###               #
########============#########################=========#####################################################
###########################################################################################################
