#                                                                                                                                                                   #
#                                                                                              ======                                   ===                         #
#                                        c                                                     ######                                   ###    ===                  #
#                               ========== ===================\                          ======######                                ===###    ###                  #
#========\                      ##########=####################===============\          ############                                ######   c###                  #
##########======================################################################=========############################################################################
#####################################################################################################################################################################
