#                                                                                                                                                                   #
#                                                                                                                                                                   #
#                                                                                                                                                                   #
#                                                                                                                                                                   #
#                                                                                                                                                                   #
#                                                                                              ======                                   ===                         #
#                                      c                                                       ######                                   ###       ===               #
#                               ==========  ==================\                          ======######                                ===###       ###               #
#========\                      ##########==###################================\         ############                                ######     c ###               #
##########======================################################################=========############################################################################
#####################################################################################################################################################################
